GGGGGGGGGGGGGGGGGGGGGGGGGGGGGGGGGGGGGGGGGGGGGGGGGGGGGGGG
CCCCCCCCCCCCCCCCCCCCCCCCCCCCCCCCCCCCCCCCCCCCCCCGGGGggGGG
CCCCCCCCCCCCCCCCCCCCCCCCCCCCCCCCCCCCCCCCCCCCCCCGGGGGGGGG
GGGGGGGGGGGGGGGGGGGGGGGGGGGGGGGGGGGGGGGGGGGGGCCGGGGGGGGG
GGGggggggGGGGGGGGGGGGGGWWWWWWWWWWWGGGGGGGGGGGCCGGGGGGGGG
GGGGggggGGGGGGGGGGWWWWWWWWWWWWWWWWWWWGGGGGGGGCCGGGGggGGG
GGGGGGGGGGGGGGGWWWWWWWWwwwwwwwwwWWWWWWWGGGGGGCCGGGGGGGGG
GGGGGGGGGGGGGGWWWWWWWwwwwwwwwwwwwwWWWWWWGGGGGCCGGGGGGGGG
GGGGGGGGGGGGGGWWWWWWwwwwwwwwwwwwwwwwwWWWGGGGGCCGGGGGGGGG
GGGGGGGGGGGGGGGGWWWwwwwwwwwwwwwwWWWWWWWGGGGGGCCGGGGGGGGG
GGGGGGGGGGGGGGGGGGWWWWWWWwwwwwwWWWWWWGGGGGGGGCCGGGGGGGGG
GGGGGGGGGGGGGGGGGGGGGWWWWWWWWWWWWWWGGGGGGGGGGCCGGGGGGGGG
GGGGGGGGGGGGGGGGGGGGGGGGGGGGGGGGGGGGGGGGGGGGGCCGGGGGGGGG
GGGGGGGGGGGGGGGGGGGGGGGGGGGGGGGGGGGGGGGGGGGGGCCGGGGGGGGG
GGGGGGGGGGGGGGGGGGGGGGGGGGGGGGGGGGGGGGGGGGGGGCCGGGGGGGGG
GGGGGGGGGGCCCCCCCCCCCCCCCCCCCCCCCCCCCCCCCCCCCCCGGGGGGGGG
GGGGGGGGGGCCCCCCCCCCCCCCCCCCCCCCCCCCCCCCCCCCCCCGGGGGGGGG
GGGGGGGGGGCCGGGGGGGGGGGGGGGGGGGGGGGGGGGGGGGGGGGGGGGGGGGG
GGGGGGGGGGCCGGGGGGGGGGGGGGGGGGGGGGGGGGGGGGGGGGGGGGGGGGGG
GGGGGGGGGGCCGGGGGGGGGGGGGGGGGGGGGGGGGGGGGGGGGGGGGGGGGGGG
GGGgggGGGGCCGGGGGGGGGGGggggggGGGGGGGGGGGGGGGGGGGgggggGGG
GGGGgGGGGGCCGGGGGGGGggggggggggggggGGGGGGGGGGGGGGGGggGGGG
GGGGGGGGGGCCGGGGGGGGGGggggggggggGGGGGGGGGGGGGGGGGGGGGGGG
GGGGGGGGGGCCGGGGGGGGGGGGGGgggGGGGGGGGGGGGGGGGGGGGGGGGGGG
GGGGGGGGGGCCGGGGGGGGGGGGGGGGGGGGGGGGGGGGGGGGGGGGGGGGGGGG
GGGGGGGGGGCCGGGGGGGGGGGGGGGGGGGGGGGGGGGGGGGGgggGGGGGGGGG
GGGGGGGGGGCCGGGGGGGGGGGGGGGGGGGGGGGGGGGGGGGGGGGGGGGGGGGG
GGGGGGGGGGCCCCCCCCCCCCCCCCCCCCCCCCCCCCCCCCCCCCCCCCCCCCCC
GGGGGGGGGGCCCCCCCCCCCCCCCCCCCCCCCCCCCCCCCCCCCCCCCCCCCCCC
GGGGGGGGGGGGGGGGGGGGGGGGGGGGgggggGGGGGGGGGGGGGGGGGGGGGGG
GGGGGGGGGGGGGGGGGGGGGGGGGGGGGGGggggggGGGGGGGGGGGGGGGGGGG
GGGGGGGGGGGGGGGGGGGGGGGGGGGGGGGGGGGGGGGGGGGGGGGGGGGGGGGG
