GGGGGGGGGGGGGGGGGGGGGGGGGGGGGGGGGGGGGGGGGGGGGGGGGGGGGGGG
CCCCCCCCCCCCCCCCCCCCCCCCCCCCCCCCCCCCCCCCCCCCCCCGGGGGGGGG
CCCCCCCCCCCCCCCCCCCCCCCCCCCCCCCCCCCCCCCCCCCCCCCGGGGGGGGG
GGGGGGGGGGGGGGGGGGGGGGGGGGGGGGGGGGGGGGGGGGGGGCCGGGGGGGGG
GGGGGGGGGGGGGGGGGGGGGGGWWWWWWWWWWWGGGGGGGGGGGCCGGGGGGGGG
GGGGGGGGGGGGGGGGGGWWWWWWWWWWWWWWWWWWWGGGGGGGGCCGGGGGGGGG
GGGGGGGGGGGGGGGWWWWWWWWwwwwwwwwwWWWWWWWGGGGGGCCGGGGGGGGG
GGGGGGGGGGGGGGWWWWWWWwwwwwwwwwwwwwWWWWWWGGGGGCCGGGGGGGGG
GGGGGGGGGGGGGGWWWWWWwwwwwwwwwwwwwwwwwWWWGGGGGCCGGGGGGGGG
GGGGGGGGGGGGGGGGWWWwwwwwwwwwwwwwWWWWWWWGGGGGGCCGGGGGGGGG
GGGGGGGGGGGGGGGGGGWWWWWWWwwwwwwWWWWWWGGGGGGGGCCGGGGGGGGG
GGGGwGWGGGGGGGGGGGGGGWWWWWWWWWWWWWWGGGGGGGGGGCCGGGGGGGGG
GGGGGGGGGGGGGGGGGGGGGGGGGGGGGGGGGGGGGGGGGGGGGCCGGGGGGGGG
GGGGGGGGGGGGGGGGGGGGGGGGGGGGGGGGGGGGGGGGGGGGGCCGGGGGGGGG
GGGGGGGGGGGGGGGGGGGGGGGGGGGGGGGGGGGGGGGGGGGGGCCGGGGGGGGG
GGGGGGGGGGCCCCCCCCCCCCCCCCCCCCCCCCCCCCCCCCCCCCCGGGGGGGGG
GGGGGGGGGGCCCCCCCCCCCCCCCCCCCCCCCCCCCCCCCCCCCCCGGGGGGGGG
GGGGGGGGGGCCGGGGGGGGGGGGGGGGGGGGGGGGGGGGGGGGGGGGGGGGGGGG
GGGGGGGGGGCCGGGGGGGGGGGGGGGGGGGGGGGGGGGGGGGGGGGGGGGGGGGG
GGGGGGGGGGCCGGGGGGGGGGGGGGGGGGGGGGGGGGGGGGGGGGGGGGGGGGGG
GGGGGGGGGGCCGGGGGGGGGGGggggggGGGGGGGGGGGGGGGGGGGGGGGGGGG
GGGGGGGGGGCCGGGGGGGGggggggggggggggGGGGGGGGGGGGGGGGGGGGGG
GGGGGGGGGGCCGGGGGGGGGGggggggggggGGGGGGGGGGGGGGGGGGGGGGGG
GGGGGGGGGGCCGGGGGGGGGGGGGGgggGGGGGGGGGGGGGGGGGGGGGGGGGGG
GGGGGGGGGGCCGGGGGGGGGGGGGGGGGGGGGGGGGGGGGGGGGGGGGGGGGGGG
GGGGGGGGGGCCGGGGGGGGGGGGGGGGGGGGGGGGGGGGGGGGGGGGGGGGGGGG
GGGGGGGGGGCCGGGGGGGGGGGGGGGGGGGGGGGGGGGGGGGGGGGGGGGGGGGG
GGGGGGGGGGCCCCCCCCCCCCCCCCCCCCCCCCCCCCCCCCCCCCCCCCCCCCCC
GGGGGGGGGGCCCCCCCCCCCCCCCCCCCCCCCCCCCCCCCCCCCCCCCCCCCCCC
GGGGGGGGGGGGGGGGGGGGGGGGGGGGGGGGGGGGGGGGGGGGGGGGGGGGGGGG
GGGGGGGGGGGGGGGGGGGGGGGGGGGGGGGGGGGGGGGGGGGGGGGGGGGGGGGG
GGGGGGGGGGGGGGGGGGGGGGGGGGGGGGGGGGGGGGGGGGGGGGGGGGGGGGGG
