GGGGGGGGGGGGGGGGGGGGGGGGGGGGGGGGGGGGGGGGGGGGGGGGGGGGGGGG
GGGGGGGGGGGGGGGGGGGGGGGGGGGGGGGGGGGGGGGGGGGGGGGGGGGGGGGG
GGGGGGGGGGGGGGGGGGGGGGGGGGGGGGGGGGGGGGGGGGGGGGGGGGGGGGGG
GGGGGGGGGGGGGGGGGGGGGGGGGGGGGGGGGGGGGGGGGGGGGGGGGGGGGGGG
GGGGGGGGGGGGGGGGGGGGGGGGGGGGGGGGGGGGGGGGGGGGGGGGGGGGGGGG
GGGGGGGGGGGGGGGGGCCCCCCCCCCCCCCCCCCCCCCGGGGGGGGGGGGGGGGG
GGGGGGGGGGGGGGGGGCCCCCCCCCCCCCCCCCCCCCCGGGGGGGGGGGGGGGGG
GGGGGGGGGGGGGGGGGCCGGGGGGGGGGGGGGGGGGCCGGGGGGGGGGGGGGGGG
GGGGGGGGGGGGGGGGGCCGGGGGGGGGGGGGGGGGGCCGGGGGGGGGGGGGGGGG
GGGGGGGGGGGGGGGGGCCGGGGGGGGGGGGGGGGGGCCGGGGGGGGGGGGGGGGG
GGGGGGGGGGGGGGGGGCCGGGGGGGGGGGGGGGGGGCCGGGGGGGGGGGGGGGGG
GGGGGGGGGGGGGGGGGCCGGGGGGGGGGGGGGGGGGCCGGGGGGGGGGGGGGGGG
GGGGGGGGGGGGGGGGGCCGGGGGGGWWWWWGGGGGGCCGGGGGGGGGGGGGGGGG
GGGGGGGGGGGGGGGGGCCGGGGGWWwwwwwWWGGGGCCGGGGGGGGGGGGGGGGG
CCCCCCCCCCCCCCCCCCCGGGGWWwwwwwwwWWGGGCCCCCCCCCCCCCCCCCCC
CCCCCCCCCCCCCCCCCCCGGGGWwwwwwwwWWWGGGCCCCCCCCCCCCCCCCCCC
GGGGGGGGGGGGGGGGGCCGGGGWWwwwwwwWWWGGGCCGGGGGGGGGGGGGGGGG
GGGGGGGGGGGGGGGGGCCGGGGGGWWwwWWWGGGGGCCGGGGGGGGGGGGGGGGG
GGGGGGGGGGGGGGGGGCCGGGGGGGGWWWGGGGGGGCCGGGGGGGGGGGGGGGGG
GGGGGGGGGGGGGGGGGCCGGGGGGGGGGGGGGGGGGCCGGGGGGGGGGGGGGGGG
GGGGGGGGGGGGGGGGGCCGGGGGGGGGGGGGGGGGGCCGGGGGGGGGGGGGGGGG
GGGGGGGGGGGGGGGGGCCGGGGGGGGGGGGGGGGGGCCGGGGGGGGGGGGGGGGG
GGGGGGGGGGGGGGGGGCCGGGGGGGGGGGGGGGGGGCCGGGGGGGGGGGGGGGGG
GGGGGGGGGGGGGGGGGCCGGGGGGGGGGGGGGGGGGCCGGGGGGGGGGGGGGGGG
GGGGGGGGGGGGGGGGGCCGGGGGGGGGGGGGGGGGGCCGGGGGGGGGGGGGGGGG
GGGGGGGGGGGGGGGGGCCCCCCCCCCCCCCCCCCCCCCGGGGGGGGGGGGGGGGG
GGGGGGGGGGGGGGGGGCCCCCCCCCCCCCCCCCCCCCCGGGGGGGGGGGGGGGGG
GGGGGGGGGGGGGGGGGGGGGGGGGGGGGGGGGGGGGGGGGGGGGGGGGGGGGGGG
GGGGGGGGGGGGGGGGGGGGGGGGGGGGGGGGGGGGGGGGGGGGGGGGGGGGGGGG
GGGGGGGGGGGGGGGGGGGGGGGGGGGGGGGGGGGGGGGGGGGGGGGGGGGGGGGG
GGGGGGGGGGGGGGGGGGGGGGGGGGGGGGGGGGGGGGGGGGGGGGGGGGGGGGGG
GGGGGGGGGGGGGGGGGGGGGGGGGGGGGGGGGGGGGGGGGGGGGGGGGGGGGGGG
